6 6 6 6 6 6 6 6 6 6 6 6 6 6 6 6 6 6
6 6 6 6 6 6 6 6 6 6 6 6 6 6 6 6 6 6
6 9 8 8 8 10 6 6 6 6 6 6 6 6 6 6 6 6
6 11 12 12 12 13 49 6 6 6 6 6 6 6 6 6 6 6
6 16 17 18 19 20 6 52 41 53 6 6 6 6 6 6 6 6
6 31 32 33 34 20 48 27 28 29 30 6 6 6 6 6 6 6
6 37 21 35 36 37 21 22 23 24 25 26 6 6 6 6 6 6
6 6 6 6 51 50 6 43 44 45 46 47 6 6 6 6 6 6
6 6 6 6 6 42 41 38 40 6 6 6 6 6 6 6 6 6
6 6 6 6 6 14 15 7 39 6 6 6 6 6 6 6 6 6
6 6 6 6 6 14 15 7 39 6 6 6 6 6 6 6 6 6
6 6 6 6 6 14 15 7 39 6 6 6 6 6 6 6 6 6
6 6 6 6 6 14 15 7 39 6 6 6 6 6 6 6 6 6
6 6 6 6 6 14 15 7 39 6 6 6 6 6 6 6 6 6
6 6 6 6 6 14 15 7 39 6 6 6 6 6 6 6 6 6
6 6 6 6 6 14 15 7 39 6 6 6 6 6 6 6 6 6
6 6 6 6 6 14 15 7 39 6 6 6 6 6 6 6 6 6
6 6 6 6 6 14 15 7 39 6 6 6 6 6 6 6 6 6